L--------
-F--H----
----H----
---RH----
-V--H-S--
---VH----
V---H----
-H--H----
----H----
----H----
---------
---------
---------
---------
